11111111111111111111111111111111111111111111111111
10001000000000001000001000100000100000000010000011
11101110111110101110101010111010101111111011111011
10100010001010100000100010000010001000001000000011
10111011101010111111111111111111111010111111111011
10100010000010100000001000000000001010000000001011
10101111111110111110101011111010101011111111101011
10101000000010000010100010001010101000001000100011
10101011111010111010111110101010111111101011111111
10100010100010001010001000101010000000101000000011
10111110101111101011111011101011111010101011111011
10100000001000101000100000101000101010101010001011
10101111111011101110101111101110101010101011101011
10001000001000001000101000100010001010101000001011
10111110101111111011101010111011101010101011111011
10001000100000001000001010000010101010101010001011
11101011111111101011111011111110101011101110101011
10101000000010101010001010000000101000100000100011
10101111111010101010101011111010101110111111111011
10001000000010001010100010000010100010000000100011
10111011111110111110111110111111111010111011101111
10100010000010000010100010001000001010100010001011
10101111101111111010101110101010111010111110111011
10001000001000100010100000100010100010000010000011
11111011111010101110111111101110101111111011111011
10001000001010100010100000101000100000001000001011
10101110101010111010101110101010111111101110111011
10100010101010001000101000101010000010001010000011
10111010101010111111101011111011111010111011111111
10100010100010000000001000000010100010000010000011
10101111111011111011111111111110101111111011111011
10100000001000101000100000001000100000001000000011
10111111101110101110111111101010111111101111111011
10100000000010000010000000101010000000100010001011
10111111111011111011111110101011111110111010101011
10100000001000100000101000101000000010000000101011
10101111101110111110101011101111111011111111111011
10101000101000000010001010000000100010000000000011
10101011101111111011111011101111101110111111111111
10101000100010000000000010001000001000101000001011
10101110111011111111111110111011111011101010101011
10100000101010000010000010000000001010000010100011
10111110101010111010111010111111101011111110111011
10000010101010101010001000001000101000001000100011
10111010101010101011101111101010111111101011101111
10001010101000101000101000101010001000101000101011
11101010101111101110111010111011101010101110101011
10001000000000000010000010000000100010000000100001
11111111111111111111111111111111111111111111111111